ALARM	AH L AA R M
CAMERA	K AE M ER AH
CAMERA(2)	K AE M R AH
COMMUNICATION	K AH M Y UW N AH K EY SH AH N
DEVICE	D IH V AY S
DISPLAY	D IH S P L EY
GPS	JH IY P IY S
GUIDE	G AY D
LOCATION	L OW K EY SH AH N
MODE	M OW D
MODES	M OW D Z
NIGHT	N AY T
QUICK	K W IH K
SETTINGS	S EH T IH NG Z
SILENCE	S AY L AH N S
START	S T AA R T
SYSTEM	S IH S T AH M
TACTICAL	T AE K T IH K AH L
VISION	V IH ZH AH N
WIRELESS	W AY R L IH S
